tileswide 25
tileshigh 20
tilewidth 32
tileheight 32

layer 0
1,0,0,0,0,0,0,0,0,0,0,0,0,0,0,0,0,0,0,0,0,0,0,0,1,
1,6,6,3,3,3,6,6,6,6,6,6,6,6,6,3,0,6,6,6,0,6,6,6,1,
1,6,0,3,0,3,0,3,0,0,0,6,0,0,0,3,0,3,0,6,0,6,0,6,1,
1,3,3,6,0,6,6,6,0,3,6,6,6,6,3,6,6,3,6,6,6,6,0,6,1,
1,3,0,0,0,6,0,6,0,3,0,0,3,3,0,6,0,6,0,3,0,3,0,3,1,
1,6,3,6,3,6,0,6,3,6,6,6,6,6,0,6,0,6,6,6,6,6,6,6,1,
1,0,0,3,0,6,0,6,0,0,0,6,0,0,0,6,0,0,0,6,0,0,0,6,1,
1,6,6,6,0,6,6,6,6,6,0,6,0,6,6,6,6,6,0,6,6,6,0,6,1,
1,6,0,0,0,0,3,6,0,3,0,6,0,6,0,6,0,6,0,6,0,6,0,6,1,
1,6,6,6,3,3,6,6,0,6,6,6,3,6,0,0,0,6,3,6,0,6,6,6,1,
1,6,0,0,0,6,3,3,3,3,0,0,0,3,6,6,6,6,0,6,6,6,6,6,1,
1,6,0,6,0,6,0,0,0,6,0,6,0,6,0,6,0,0,0,3,0,0,0,6,1,
1,6,6,6,6,6,0,6,6,6,6,6,6,6,0,6,6,6,3,6,3,6,6,6,1,
1,6,0,0,0,3,0,6,0,3,0,6,0,3,0,0,0,3,0,6,0,6,0,0,1,
1,6,6,6,6,6,3,6,6,6,6,6,0,3,6,6,6,3,0,6,6,3,6,6,1,
1,0,0,3,0,0,0,3,0,0,0,3,0,6,6,6,0,6,0,0,0,6,0,3,1,
1,6,6,6,0,6,6,6,0,6,6,6,3,6,6,6,0,6,0,6,6,6,0,6,1,
1,6,0,6,0,6,0,6,0,6,0,6,0,6,0,0,0,6,0,6,0,6,0,6,1,
1,6,6,6,6,6,0,6,6,6,6,6,0,6,6,6,6,6,3,6,6,6,6,6,1,
0,0,0,0,0,0,0,0,0,0,0,0,0,0,0,0,0,0,0,0,0,0,0,0,0,

