1,0,0,0,0,0,0,0,0,0,0,0,0,0,0,0,0,0,0,0,0,0,0,0,1,
1,4,4,4,2,2,4,4,4,4,4,4,4,4,4,2,0,4,4,4,0,4,4,4,1,
1,4,0,2,0,2,0,2,0,0,0,4,0,0,0,2,0,2,0,4,0,4,0,4,1,
1,4,2,4,0,4,4,4,0,2,4,4,4,4,2,4,4,2,4,4,4,4,0,4,1,
1,2,0,0,0,4,0,4,0,2,0,0,2,2,0,4,0,4,0,2,0,2,0,2,1,
1,4,2,4,2,4,0,4,2,4,4,4,4,4,0,4,0,4,4,4,4,4,4,4,1,
1,0,0,2,0,4,0,4,0,0,0,4,0,0,0,4,0,0,0,4,0,0,0,4,1,
1,4,4,4,0,4,4,4,4,4,0,4,0,4,4,4,4,4,0,4,4,4,0,4,1,
1,4,0,0,0,0,2,4,0,2,0,4,0,4,0,4,0,4,0,4,0,4,0,4,1,
1,4,4,4,2,2,4,4,0,4,4,4,2,4,0,0,0,4,2,4,0,4,4,4,1,
1,4,0,0,0,4,2,2,2,2,0,0,0,2,4,4,4,4,0,4,4,4,4,4,1,
1,4,0,4,0,4,0,0,0,4,0,4,0,4,0,4,0,0,0,2,0,0,0,4,1,
1,4,4,4,4,4,0,4,4,4,4,4,4,4,0,4,4,4,2,4,2,4,4,4,1,
1,4,0,0,0,2,0,4,0,2,0,4,0,2,0,0,0,2,0,4,0,4,0,0,1,
1,4,4,4,4,4,2,4,4,4,4,4,0,2,4,4,4,2,0,4,4,2,4,4,1,
1,0,0,2,0,0,0,2,0,0,0,2,0,4,4,4,0,4,0,0,0,4,0,2,1,
1,4,4,4,0,4,4,4,0,4,4,4,2,4,4,4,0,4,0,4,4,4,0,4,1,
1,4,0,4,0,4,0,4,0,4,0,4,0,4,0,0,0,4,0,4,0,4,0,4,1,
1,4,4,4,4,4,0,4,4,4,4,4,0,4,4,4,4,4,2,4,4,4,4,4,1,
0,0,0,0,0,0,0,0,0,0,0,0,0,0,0,0,0,0,0,0,0,0,0,0,0,

